TAG	TEXT	COMMENT
ACCESSIBILITY_WELCOME_TO_HEARTHSTONE	Bienvenido a Hearthstone	
	
ACCESSIBILITY_PRESS_KEY_TO_START	Pulsa {0} para iniciar	0=key e.g. Press Enter to start
ACCESSIBILITY_PRESS_KEY_TO_CONTINUE	Pulsa {0} para continuar	0=key e.g. Press Enter to continue
ACCESSIBILITY_PRESS_KEY_TO_FINISH	Pulsa {0} para finalizar	0=key e.g. Press Enter to finish
ACCESSIBILITY_PRESS_KEY_TO_EXIT	Pulsa {0} para cerrar	0=key e.g. Press Enter to exit
ACCESSIBILITY_PRESS_KEY_ONCE_DONE	pulsa {0} una vez que hayas terminado	0=key e.g. Press Enter once you're done

ACCESSIBILITY_MENU_HELP_NO_BACK_BUTTON	Utiliza las flechas arriba y abajo para navegar por el menú. Pulsa {0} para seleccionar una opción	0=Enter key
ACCESSIBILITY_MENU_HELP_WITH_BACK_BUTTON	Utilice las flechas arriba y abajo para navegar por el menú. Pulsa {0} para seleccionar una opción. Pulsa {1} para retroceder	0=Enter key 1=Backspace key
ACCESSIBILITY_MENU_OPTION_FORMAT	{0} {1} de {2}	0=option name 1=option number 2=options count e.g. Options 1 of 2

ACCESSIBILITY_OPTIONS_MENU_TITLE	Menú de opciones	
ACCESSIBILITY_OPTIONS_MENU_MASTER_VOLUME_OPTION	Ajustar el volumen general	
ACCESSIBILITY_OPTIONS_MENU_FULLSCREEN_OPTION	Activar pantalla completa	
ACCESSIBILITY_OPTIONS_MENU_ADJUST_MASTER_VOLUME	Utilice las flechas izquierda y derecha para ajustar el volumen	
ACCESSIBILITY_OPTIONS_MENU_FULLSCREEN_ON	Pantalla completa activada	
ACCESSIBILITY_OPTIONS_MENU_FULLSCREEN_OFF	Pantalla completa desactivada	
ACCESSIBILITY_HUB_MAIN_MENU_TITLE	Menú principal	
ACCESSIBILITY_HUB_MAIN_MENU_OPTION_HELP	Pulsa {0} en cualquier momento si necesitas ayuda. Si quieres desactivar la accesibilidad para jugar con una persona vidente y usar el mouse, puedes pulsar {1}. Recuerda pulsar {1} una vez que hayas terminado para reactivar la accesibilidad	0=Esc key 1=F8 key 

ACCESSIBILITY_GLOBAL_LOADING_GAME	Cargando juego	
ACCESSIBILITY_GLOBAL_CLOSING_GAME	Cerrando el juego	
ACCESSIBILITY_GLOBAL_GAME_LOADED	Juego cargado	
ACCESSIBILITY_GLOBAL_LOADING	Cargando	
ACCESSIBILITY_GLOBAL_PLEASE_WAIT	Espera por favor	
ACCESSIBILITY_GLOBAL_CARD	Carta	
ACCESSIBILITY_GLOBAL_CARD_PLURAL	Cartas	
ACCESSIBILITY_GLOBAL_HERO	Héroe	
ACCESSIBILITY_GLOBAL_HERO_POWER	Poder de héroe	
ACCESSIBILITY_GLOBAL_GAME_SPEED	Velocidad del juego {0}	0=current game speed
ACCESSIBILITY_GLOBAL_NEW_HEARTHSTONE_ACCESS_VERSION_AVAILABLE	Hay una nueva versión disponible de Hearthstone Access. Ejecuta el parche de nuevo siempre que sea posible, ya que puede contener correcciones de errores u otras novedades.	

ACCESSIBILITY_FORMATTING_PERIOD	.	
ACCESSIBILITY_FORMATTING_SENTENCE_ENDING_CHARACTERS	.!?;	
ACCESSIBILITY_FORMATTING_LIST_SEPARATOR	, 	e.g. the ", " in A, B, C, D and E
ACCESSIBILITY_FORMATTING_LIST_FINAL_SEPARATOR	 y 	e.g. the " and " in A, B, C, D and E

ACCESSIBILITY_FORMATTING_ORDINAL_NUMBER_1	número 1	Languages with grammatical genders can work around using digits and configure text that uses ordinal numbers such as "minion number 1" instead of "first minion"
ACCESSIBILITY_FORMATTING_ORDINAL_NUMBER_2	número 2	
ACCESSIBILITY_FORMATTING_ORDINAL_NUMBER_3	número 3	
ACCESSIBILITY_FORMATTING_ORDINAL_NUMBER_4	número 4	
ACCESSIBILITY_FORMATTING_ORDINAL_NUMBER_5	número 5	
ACCESSIBILITY_FORMATTING_ORDINAL_NUMBER_6	número 6	
ACCESSIBILITY_FORMATTING_ORDINAL_NUMBER_7	número 7	
ACCESSIBILITY_FORMATTING_ORDINAL_NUMBER_8	número 8	
ACCESSIBILITY_FORMATTING_ORDINAL_NUMBER_9	número 9	
ACCESSIBILITY_FORMATTING_ORDINAL_NUMBER_10	número 10	

ACCESSIBILITY_INPUT_COMMAND_WITH_MODIFIER_FORMAT	Shift + {0}	0=key e.g. Shift + F
ACCESSIBILITY_INPUT_KEY_OVERRIDE_Return	Enter	Optional. Overrides the Return key to be read as Enter by TTS
ACCESSIBILITY_INPUT_KEY_OVERRIDE_A	eh	Optional. Overrides the A key to be read as eh by TTS
ACCESSIBILITY_INPUT_KEY_OVERRIDE_I	eye	Optional. Overrides the I key to be read as eye by TTS

ACCESSIBILITY_READ_CARD_COST	{0} mana	0=card cost
ACCESSIBILITY_READ_CARD_ATK_HEALTH	{0} {1}	0=attack 1=health e.g. 3 2
ACCESSIBILITY_READ_CARD_ATK_DURABILITY	{0} {1}	0=attack 1=durability e.g. 1 3
ACCESSIBILITY_READ_HERO_CARD_ATK	{0} de ataque	0=attack
ACCESSIBILITY_READ_HERO_CARD_HEALTH	{0} de salud	0=health
ACCESSIBILITY_READ_HERO_CARD_ARMOR	{0} de armadura	0=armor
ACCESSIBILITY_READ_CARD_N_COPIES	{0} copias	0=number of copies
ACCESSIBILITY_READ_COLLECTION_CARD_NAME_GOLDEN	{0} - edición dorada	0=card name e.g. {fireball} - golden edition
ACCESSIBILITY_READ_COLLECTION_CARD_NAME_DIAMOND	{0} - edición diamante	0=card name

ACCESSIBILITY_GAMEPLAY_OPPONENT_TURN	Turno del oponente	
ACCESSIBILITY_GAMEPLAY_TURN_ENDED	Turno terminado	
ACCESSIBILITY_GAMEPLAY_CARD_IN_ZONE_TRIGGERED	El efecto de {0} se ha activado	0=full card name in zone e.g. {Your second Murloc Raider} triggered
ACCESSIBILITY_GAMEPLAY_PLAYER_CARD_TRIGGERED	El efecto de tu {0} se ha activado	0=card name e.g. Your {Psyfiend} triggered
ACCESSIBILITY_GAMEPLAY_OPPONENT_CARD_TRIGGERED	El efecto de {0} del oponente se ha activado	0=card name e.g. Your opponent's {Psyfiend} triggered
ACCESSIBILITY_GAMEPLAY_OPPONENT_CARD_TRIGGERED_BIG_CARD	El efecto de {0} del oponente se ha activado; {1}	0=card name 1=cardText e.g. Your opponent's {Psyfiend} triggered; {After you cast a Shadow spell, deal 2 damage to each Hero.}
ACCESSIBILITY_GAMEPLAY_PLAYER_PLAYED_CARD	Jugaste {0}	0=card name e.g. You played {Fireball}
ACCESSIBILITY_GAMEPLAY_PLAYER_PLAYED_CARD_BIG_CARD	Jugaste {0}; {1}	0=card name 1=card text e.g. You played {Fireball}; {Deal 6 damage.}
ACCESSIBILITY_GAMEPLAY_OPPONENT_PLAYED_CARD	Tu oponente jugó {0}	0=card name e.g. Your opponent played {Fireball}
ACCESSIBILITY_GAMEPLAY_OPPONENT_PLAYED_CARD_BIG_CARD	Tu oponente jugó {0}; {1}	0=card name 1=card text e.g. Your opponent played {Fireball}; {Deal 6 damage.}
ACCESSIBILITY_GAMEPLAY_PLAYER_SUMMONED_MINION	Invocaste a {0}	0=minion name e.g. You summoned {Raid Leader}
ACCESSIBILITY_GAMEPLAY_PLAYER_SUMMONED_MINION_BIG_CARD	Invocaste a {0}; {1} {2} {3}	0=minion name 1=attack 2=health 3=card text e.g. You summoned {Raid Leader}; {2} {3} {Your other minions have +1 Attack.}
ACCESSIBILITY_GAMEPLAY_OPPONENT_SUMMONED_MINION	Tu oponente invocó a {0}	0=minion name e.g. Your opponent summoned {Raid Leader}
ACCESSIBILITY_GAMEPLAY_OPPONENT_SUMMONED_MINION_BIG_CARD	Tu oponente invocó a {0}; {1} {2} {3}	0=minion name 1=attack 2=health 3=card text e.g. Your opponent summoned {Raid Leader}; {2} {3} {Your other minions have +1 Attack.}
ACCESSIBILITY_GAMEPLAY_PLAYER_EQUIPPED_WEAPON	Te has equipado {0}	0=weapon name e.g. You equipped {Aldrachi Warblades}
ACCESSIBILITY_GAMEPLAY_PLAYER_EQUIPPED_WEAPON_BIG_CARD	Te has equipado {0}; {1} {2} {3}	0=weapon name 1=attack 2=durability 3=card text e.g. You equipped {Aldrachi Warblades}; {2} {2} {Lifesteal}
ACCESSIBILITY_GAMEPLAY_OPPONENT_EQUIPPED_WEAPON	Tu oponente se equipó {0}	0=weapon name e.g. Your opponent equipped {Aldrachi Warblades}
ACCESSIBILITY_GAMEPLAY_OPPONENT_EQUIPPED_WEAPON_BIG_CARD	Tu oponente se equipó {0}; {1} {2} {3}	0=weapon name 1=attack 2=durability 3=card text e.g. Your opponent equipped {Aldrachi Warblades}; {2} {2} {Lifesteal}
ACCESSIBILITY_GAMEPLAY_PLAYER_USED_HERO_POWER	Usaste {0}	0=hero power name e.g. You used {Fireblast}
ACCESSIBILITY_GAMEPLAY_PLAYER_USED_HERO_POWER_BIG_CARD	Usaste {0}; {1}	0=hero power name 1=card text e.g. You used {Fireblast}; {Hero Power Deal 1 damage.}
ACCESSIBILITY_GAMEPLAY_OPPONENT_USED_HERO_POWER	Tu oponente usó {0}	0=hero power name e.g. Your opponent used {Fireblast}
ACCESSIBILITY_GAMEPLAY_OPPONENT_USED_HERO_POWER_BIG_CARD	Tu oponente usó {0}; {1}	0=hero power name 1=card text e.g. Your opponent used {Fireblast}; {Hero Power Deal 1 damage.}
ACCESSIBILITY_GAMEPLAY_PLAYER_CAST_SECRET	Lanzas {0}	0=secret name e.g. You cast {Counterspell}
ACCESSIBILITY_GAMEPLAY_PLAYER_CAST_SECRET_BIG_CARD	Lanzas {0}; {1}	0=secret name 1=card text e.g. You cast {Counterspell}; {Secret: When your opponent casts a spell, Counter it.}
ACCESSIBILITY_GAMEPLAY_OPPONENT_CAST_SECRET	Tu oponente lanza 1 {0} secreto	0=secret class e.g. Your opponent cast 1 {mage} secret
ACCESSIBILITY_GAMEPLAY_OPPONENT_CAST_N_SECRETS	Tu oponente lanza {0} secretos	0=number of secrets e.g. Your opponent cast {2} secrets
ACCESSIBILITY_GAMEPLAY_PLAYER_DREW_CARD_FROM_EMPTY_DECK	Intentaste robar una carta de un mazo vacío	
ACCESSIBILITY_GAMEPLAY_OPPONENT_DREW_CARD_FROM_EMPTY_DECK	Tu oponente intentó robar una carta de un mazo vacío	
ACCESSIBILITY_GAMEPLAY_PLAYER_DREW_CARD_BUT_BURNED	Has tomado 1 {0} pero se quemó	0=card e.g. You drew 1 {Fireball} but it burned
ACCESSIBILITY_GAMEPLAY_OPPONENT_DREW_CARD_BUT_BURNED	Tu oponente tomó 1 {0} pero se quemó	0=card e.g. Your opponent drew 1 {Fireball} but it burned
ACCESSIBILITY_GAMEPLAY_ENTITY_ATTACKED	{0} atacó a {1}	0=attacker name 1=defender name e.g. {Your Murloc Raider} attacked {your opponent's Hero}
ACCESSIBILITY_GAMEPLAY_ENTITY_ATTACKED_OTHER	{0} intentó atacar a {1} pero atacó a {2} en su lugar.	0=attacker name 1=proposed defender name 2=real defender name e.g. {Your Murloc Raider} attempted to attack {your opponent's Hero} but attacked {your opponent's Bloodfen Raptor} instead

ACCESSIBILITY_GAMEPLAY_PLAYER_TURN_START_READ_MANA	Tienes{0} mana	0=mana
ACCESSIBILITY_GAMEPLAY_YOU_GO_FIRST	Vas primero	
ACCESSIBILITY_GAMEPLAY_OPPONENT_GOES_FIRST	Tu oponente va primero	
ACCESSIBILITY_GAMEPLAY_YOU_START_WITH_N_CARDS	Comienzas con {0} |4(carta,cartas)	0=number of cards
ACCESSIBILITY_GAMEPLAY_PLAYER_DREW_CARDS	Robaste {0}	0=card names e.g. You drew {1 Bloodfen Raptor and 1 Murloc Raider}
ACCESSIBILITY_GAMEPLAY_OPPONENT_DREW_CARDS	Tu oponente robó {0}	0=card names e.g. Your opponent drew {1 Bloodfen Raptor and 1 Murloc Raider}
ACCESSIBILITY_GAMEPLAY_PLAYER_DISCARDED_CARDS	Descartaste {0}	0=card names e.g. You discarded {1 Bloodfen Raptor and 1 Murloc Raider}
ACCESSIBILITY_GAMEPLAY_OPPONENT_DISCARDED_CARDS	Tu oponente descartó {0}	0=card names e.g. Your opponent discarded {1 Bloodfen Raptor and 1 Murloc Raider}
ACCESSIBILITY_GAMEPLAY_YOU_GET_THE_COIN	Tomas la moneda	
ACCESSIBILITY_GAMEPLAY_WAITING_FOR_OPPONENT	Esperando a un oponente	
ACCESSIBILITY_GAMEPLAY_QUERY_SUMMON_MINION	¿Invocar?	
ACCESSIBILITY_GAMEPLAY_QUERY_SUMMON_MINION_AT_THE_RIGHT	¿Invocar a la derecha?	
ACCESSIBILITY_GAMEPLAY_QUERY_SUMMON_MINION_AT_THE_LEFT	¿Invocar a la izquierda?	
ACCESSIBILITY_GAMEPLAY_QUERY_SUMMON_MINION_BETWEEN	¿Invocar entre {0} y {1}?	Summon between {Murloc Raider} and {Bloodfen Raptor}?
ACCESSIBILITY_GAMEPLAY_QUERY_PLAY_CARD	¿Jugar carta?	
ACCESSIBILITY_GAMEPLAY_QUERY_END_TURN_WHEN_VALID_PLAYS	Aún tienes jugadas válidas. ¿Estás seguro?	
ACCESSIBILITY_GAMEPLAY_SEND_TO_FACE_NO_MINIONS	No tienes esbirros invocados	
ACCESSIBILITY_GAMEPLAY_SEND_TO_FACE_HERO_CANT_BE_ATTACKED	El héroe de tu oponente no puede ser atacado	
ACCESSIBILITY_GAMEPLAY_SEND_TO_FACE_HERO_CANT_BE_TARGETED	El héroe de tu oponente no puede ser el objetivo	
ACCESSIBILITY_GAMEPLAY_SEND_TO_FACE_HERO_NO_VALID_ATTACKERS	Ninguno de tus esbirros puede atacar al héroe de tu oponente	
ACCESSIBILITY_GAMEPLAY_CHOOSE_TARGET	Elige un objetivo	

ACCESSIBILITY_GAMEPLAY_SEE_ZONE_PLAYER_HAND_EMPTY	Tu mano esta vacía	
ACCESSIBILITY_GAMEPLAY_SEE_ZONE_PLAYER_MINIONS_EMPTY	No tienes esbirros invocados	
ACCESSIBILITY_GAMEPLAY_SEE_ZONE_OPPONENT_MINIONS_EMPTY	Tu oponente no tiene esbirros invocados	
ACCESSIBILITY_GAMEPLAY_SEE_ZONE_PLAYER_SECRETS_EMPTY	No tienes secretos	
ACCESSIBILITY_GAMEPLAY_SEE_ZONE_OPPONENT_SECRETS_EMPTY	Tu oponente no tiene secretos	
ACCESSIBILITY_GAMEPLAY_SEE_ZONE_OPPONENT_SECRETS_COUNT	Tu oponente tiene {0} |4(secreto,secretos)	0=number of secrets
ACCESSIBILITY_GAMEPLAY_SEE_ZONE_PLAYER_HERO_POWER_EMPTY	No tienes poder de héroe	
ACCESSIBILITY_GAMEPLAY_SEE_ZONE_OPPONENT_HERO_POWER_EMPTY	Tu oponente no tiene poder de héroe	
ACCESSIBILITY_GAMEPLAY_SEE_ZONE_PLAYER_WEAPON_EMPTY	No tienes arma equipada	
ACCESSIBILITY_GAMEPLAY_SEE_ZONE_OPPONENT_WEAPON_EMPTY	Tu oponente no tiene un arma equipada	
ACCESSIBILITY_GAMEPLAY_READ_PLAYER_MANA_CURRENT_AND_TOTAL	Tienes {0} de {1} mana	0=current mana 1=total mana
ACCESSIBILITY_GAMEPLAY_READ_PLAYER_MANA	Tienes {0} mana	0=current and total mana
ACCESSIBILITY_GAMEPLAY_READ_OPPONENT_MANA	Tu oponente tiene {0} mana	0=current and total mana
ACCESSIBILITY_GAMEPLAY_READ_OPPONENT_HAND	Mano del oponente. {0} |4(carta,cartas)	0=number of cards
ACCESSIBILITY_GAMEPLAY_READ_PLAYER_DECK	Mazo. {0} |4(carta,cartas)	0=number of cards
ACCESSIBILITY_GAMEPLAY_READ_OPPONENT_DECK	Mazo del oponente. {0} |4(carta,cartas)	0=number of cards
ACCESSIBILITY_GAMEPLAY_NO_MORE_VALID_OPTIONS	No hay más opciones válidas	
ACCESSIBILITY_GAMEPLAY_NO_VALID_PLAYS	No tienes jugadas válidas	

ACCESSIBILITY_GAMEPLAY_GAME_OVER_WON	Has ganado	
ACCESSIBILITY_GAMEPLAY_GAME_OVER_LOST	Has perdido	
ACCESSIBILITY_GAMEPLAY_GAME_OVER_TIED	Has empatado	
ACCESSIBILITY_GAMEPLAY_GAME_OVER_GENERIC	Fin del juego	

ACCESSIBILITY_GAMEPLAY_ZONE_PLAYER_HERO	Tu hérue	Read when you press v
ACCESSIBILITY_GAMEPLAY_ZONE_OPPONENT_HERO	Herue de tu oponente	Read when you press f
ACCESSIBILITY_GAMEPLAY_ZONE_PLAYER_HERO_POWER	Tu poder de hérue	Read when you press r
ACCESSIBILITY_GAMEPLAY_ZONE_OPPONENT_HERO_POWER	Poder de hérue de tu oponente	Read when you press Shift+r
ACCESSIBILITY_GAMEPLAY_ZONE_PLAYER_WEAPON	Tu arma	Read when you press w
ACCESSIBILITY_GAMEPLAY_ZONE_OPPONENT_WEAPON	Arma de tu oponente	Read when you press Shift+w
ACCESSIBILITY_GAMEPLAY_ZONE_PLAYER_HAND	Tu mano	Read when you press c
ACCESSIBILITY_GAMEPLAY_ZONE_OPPONENT_HAND	Mano de tu oponente	Read when you press Shift+c
ACCESSIBILITY_GAMEPLAY_ZONE_PLAYER_MINIONS	Tus esbirros	Read when you press b
ACCESSIBILITY_GAMEPLAY_ZONE_OPPONENT_MINIONS	Esvirros de tu oponente	Read when you press g
ACCESSIBILITY_GAMEPLAY_ZONE_PLAYER_SECRETS	Tus secretos	Read when you press s
ACCESSIBILITY_GAMEPLAY_ZONE_OPPONENT_SECRETS	Secretos de tu oponente	Read when you press Shift+s

ACCESSIBILITY_GAMEPLAY_DIFF_ZONE_PLAYER_HAND	Tu Mano	e.g. Your opponent's Murloc Raider moved from your opponent's hand to {your hand}
ACCESSIBILITY_GAMEPLAY_DIFF_ZONE_OPPONENT_HAND	la mano de tu oponente	e.g. Your Murloc Raider moved to {you opponent's hand}
ACCESSIBILITY_GAMEPLAY_DIFF_ZONE_PLAYER_BATTLEFIELD	tu campo de batalla	e.g. Your Murloc Raider moved from your graveyard to {your battlefield}
ACCESSIBILITY_GAMEPLAY_DIFF_ZONE_OPPONENT_BATTLEFIELD	el campo de batalla de tu oponente	e.g. Your Murloc Raider moved from your graveyard to {your battlefield}
ACCESSIBILITY_GAMEPLAY_DIFF_ZONE_PLAYER_SECRETS	tus secretos	e.g. Your Ice Block moved from your deck to {your secrets}
ACCESSIBILITY_GAMEPLAY_DIFF_ZONE_OPPONENT_SECRETS	los secretos de tu oponente	e.g. Your Ice Block moved from your deck to {your opponent's secrets}
ACCESSIBILITY_GAMEPLAY_DIFF_ZONE_PLAYER_DECK	tu mazo	e.g. Your Fireball moved from {your deck} to your opponent's deck
ACCESSIBILITY_GAMEPLAY_DIFF_ZONE_OPPONENT_DECK	El mazo de tu oponente	e.g. Your Fireball moved from your deck to {your opponent's deck}
ACCESSIBILITY_GAMEPLAY_DIFF_ZONE_PLAYER_GRAVEYARD	tu cementerio	e.g. Your Murloc Raider moved from {your graveyard} to your battlefield
ACCESSIBILITY_GAMEPLAY_DIFF_ZONE_OPPONENT_GRAVEYARD	el cementerio de tu oponente	e.g. Your opponent's Murloc Raider moved from {your opponent's graveyard} to your battlefield

ACCESSIBILITY_GAMEPLAY_MULLIGAN	Mulligan	
ACCESSIBILITY_GAMEPLAY_MULLIGAN_WILL_BE_REPLACED	Será reemplazada	
ACCESSIBILITY_GAMEPLAY_MULLIGAN_WILL_NOT_BE_REPLACED	No será reemplazada	
ACCESSIBILITY_GAMEPLAY_MULLIGAN_HELP	Utiliza las flechas para revisar tus cartas iniciales y {0} para marcar las que te gustaría reemplazar. Pulsa {1} una vez que hayas terminado	0=spacebar key 1=Enter key
ACCESSIBILITY_GAMEPLAY_MULLIGAN_HELP_WAITING_FOR_GAME_TO_START	El juego está a punto de empezar. Espera por favor	

ACCESSIBILITY_GAMEPLAY_DIFF_ENTITY_DIED	Fue destruído	Singular and plural are often the same in English
ACCESSIBILITY_GAMEPLAY_DIFF_MULTIPLE_ENTITIES_DIED	Fueron destruídos	Singular and plural are often the same in English
ACCESSIBILITY_GAMEPLAY_DIFF_WEAPON_BROKE	rompió	
ACCESSIBILITY_GAMEPLAY_DIFF_ENTITY_TRANSFORMED	Se ha transformado en 1 {0}	0=name of the card it transformed into e.g. transformed into 1 {Sheep}
ACCESSIBILITY_GAMEPLAY_DIFF_MULTIPLE_ENTITIES_TRANSFORMED	Se han transformado en 1 {0}	0=name of the card it transformed into e.g. transformed into 1 {Sheep}
ACCESSIBILITY_GAMEPLAY_DIFF_ENTITY_TOOK_N_DAMAGE	Recibió {0} Daño	0=damage taken
ACCESSIBILITY_GAMEPLAY_DIFF_MULTIPLE_ENTITIES_TOOK_N_DAMAGE	Recibieron {0} daño	0=damage taken
ACCESSIBILITY_GAMEPLAY_DIFF_ENTITY_N_DURABILITY	{0} durabilidad	0=gained/lost durability amount
ACCESSIBILITY_GAMEPLAY_DIFF_ENTITY_N_ATTACK	{0} ataque	0=gained/lost attack amount
ACCESSIBILITY_GAMEPLAY_DIFF_ENTITY_N_HEALTH	{0} salud	0=gained/lost health amount
ACCESSIBILITY_GAMEPLAY_DIFF_ENTITY_N_ARMOR	{0} armadura	0=gained/lost armor amount
ACCESSIBILITY_GAMEPLAY_DIFF_ENTITY_RECOVERED_N_HEALTH	Recuperó {0} salud	0=recovered health
ACCESSIBILITY_GAMEPLAY_DIFF_MULTIPLE_ENTITIES_RECOVERED_N_HEALTH	Recuperaron {0} salud	0=recovered health
ACCESSIBILITY_GAMEPLAY_DIFF_ENTITY_BECAME_INVULNERABLE	se volvió invulnerable	
ACCESSIBILITY_GAMEPLAY_DIFF_MULTIPLE_ENTITIES_BECAME_INVULNERABLE	se volvierpm invulnerables	
ACCESSIBILITY_GAMEPLAY_DIFF_ENTITY_BECAME_SILENCED	fue silenciado	
ACCESSIBILITY_GAMEPLAY_DIFF_MULTIPLE_ENTITIES_BECAME_SILENCED	fueron silenciados	
ACCESSIBILITY_GAMEPLAY_DIFF_ENTITY_BECAME_DORMANT	Quedó dormido	
ACCESSIBILITY_GAMEPLAY_DIFF_MULTIPLE_ENTITIES_BECAME_DORMANT	quedaron dormidos	
ACCESSIBILITY_GAMEPLAY_DIFF_ENTITY_NO_LONGER_DORMANT	ya no está dormido	
ACCESSIBILITY_GAMEPLAY_DIFF_MULTIPLE_ENTITIES_NO_LONGER_DORMANT	ya no están dormidos	
ACCESSIBILITY_GAMEPLAY_DIFF_ENTITY_BECAME_FROZEN	se congeló	
ACCESSIBILITY_GAMEPLAY_DIFF_MULTIPLE_ENTITIES_BECAME_FROZEN	se congelaron	
ACCESSIBILITY_GAMEPLAY_DIFF_ENTITY_NO_LONGER_FROZEN	ya no está congelado	
ACCESSIBILITY_GAMEPLAY_DIFF_MULTIPLE_ENTITIES_NO_LONGER_FROZEN	ya no estan congelados	
ACCESSIBILITY_GAMEPLAY_DIFF_ENTITY_BECAME_IMMUNE	se volvió inmune	
ACCESSIBILITY_GAMEPLAY_DIFF_MULTIPLE_ENTITIES_BECAME_IMMUNE	se volvieron inmunes	
ACCESSIBILITY_GAMEPLAY_DIFF_ENTITY_NO_LONGER_IMMUNE	ya no es inmune	
ACCESSIBILITY_GAMEPLAY_DIFF_MULTIPLE_ENTITIES_NO_LONGER_IMMUNE	ya no son inmunes	
ACCESSIBILITY_GAMEPLAY_DIFF_ENTITY_BECAME_MAGNETIC	se volvió magnético	
ACCESSIBILITY_GAMEPLAY_DIFF_MULTIPLE_ENTITIES_BECAME_MAGNETIC	se volvieron magnéticos	
ACCESSIBILITY_GAMEPLAY_DIFF_ENTITY_NO_LONGER_MAGNETIC	ya no es magnético	
ACCESSIBILITY_GAMEPLAY_DIFF_MULTIPLE_ENTITIES_NO_LONGER_MAGNETIC	ya no son magnéticos	
ACCESSIBILITY_GAMEPLAY_DIFF_ENTITY_BECAME_POISONOUS	se volvió venenoso	
ACCESSIBILITY_GAMEPLAY_DIFF_MULTIPLE_ENTITIES_BECAME_POISONOUS	se volvieron venenosos	
ACCESSIBILITY_GAMEPLAY_DIFF_ENTITY_NO_LONGER_POISONOUS	ya no es venenoso	
ACCESSIBILITY_GAMEPLAY_DIFF_MULTIPLE_ENTITIES_NO_LONGER_POISONOUS	ya no son venenosos	
ACCESSIBILITY_GAMEPLAY_DIFF_ENTITY_BECAME_STEALTHED	ahora es sigiloso	
ACCESSIBILITY_GAMEPLAY_DIFF_MULTIPLE_ENTITIES_BECAME_STEALTHED	ahora son sigilosos	
ACCESSIBILITY_GAMEPLAY_DIFF_ENTITY_GAINED_STATS	ha ganado {0}	0=stats e.g. gained {taunt, 3 attack and 2 health}
ACCESSIBILITY_GAMEPLAY_DIFF_MULTIPLE_ENTITIES_GAINED_STATS	han ganado {0}	0=stats e.g. gained {taunt, 3 attack and 2 health}
ACCESSIBILITY_GAMEPLAY_DIFF_ENTITY_LOST_STATS	pierde {0}	0=stats e.g. lost {taunt, 3 attack and 2 health}
ACCESSIBILITY_GAMEPLAY_DIFF_MULTIPLE_ENTITIES_LOST_STATS	pierden {0}	0=stats e.g. lost {taunt, 3 attack and 2 health}

ACCESSIBILITY_GAMEPLAY_DIFF_ENTITY_SPEECHES_FORMAT	{0} {1}	0=entities 1=effect e.g. {Your Hero and your Raid Leader} {took 3 damage}

ACCESSIBILITY_GAMEPLAY_DIFF_PLAYER_ENTITY_FULL_NAME	tu {0}	0=entity name e.g. Your {Raid Leader}
ACCESSIBILITY_GAMEPLAY_DIFF_OPPONENT_ENTITY_FULL_NAME	{0} de tu oponente	0=entity name e.g. Your opponent's {Raid Leader}
ACCESSIBILITY_GAMEPLAY_DIFF_PLAYER_ENTITY_FULL_NAME_IN_LIST	Tu {1} {0}	0=ordinal number 1=entity name e.g. Your {second} {Raid Leader}
ACCESSIBILITY_GAMEPLAY_DIFF_OPPONENT_ENTITY_FULL_NAME_IN_LIST	{1} {0} de tu oponente	0=ordinal number 1=entity name e.g. Your opponent's {second} {Raid Leader}
ACCESSIBILITY_GAMEPLAY_DIFF_MULTIPLE_ENTITIES	{0} {1}	0=number of entities 1=entity name e.g. {2} {Raid Leader}

ACCESSIBILITY_GAMEPLAY_DIFF_GROUP_EVERYONE	todos	e.g. {everyone} took 2 damage
ACCESSIBILITY_GAMEPLAY_DIFF_GROUP_EVERYONE_ELSE	los demás	e.g. {everyone else} took 2 damage
ACCESSIBILITY_GAMEPLAY_DIFF_GROUP_ALL_MINIONS	todos los esbirros	e.g. {All minions} took 2 damage
ACCESSIBILITY_GAMEPLAY_DIFF_GROUP_ALL_OTHER_MINIONS	el resto de esbirros	e.g. {All other minions} took 2 damage
ACCESSIBILITY_GAMEPLAY_DIFF_GROUP_BOTH_HEROES	ambos héroes	e.g. {Both Heroes} took 2 damage
ACCESSIBILITY_GAMEPLAY_DIFF_GROUP_ENEMIES	tus enemigos	e.g. {Your enemies} took 2 damage
ACCESSIBILITY_GAMEPLAY_DIFF_GROUP_OTHER_ENEMIES	tus otros enemigos	e.g. {Your other enemies} took 2 damage
ACCESSIBILITY_GAMEPLAY_DIFF_GROUP_FRIENDLY_CHARACTERS	Tus personajes amistosos	e.g. {Your friendly characters} took 2 damage
ACCESSIBILITY_GAMEPLAY_DIFF_GROUP_OTHER_FRIENDLY_CHARACTERS	tus otros personajes amistosos	e.g. {Your other friendly characters} took 2 damage
ACCESSIBILITY_GAMEPLAY_DIFF_GROUP_OPPONENT_MINIONS	Los esbirros de tu oponente	e.g. {Your opponent's minions} took 2 damage
ACCESSIBILITY_GAMEPLAY_DIFF_GROUP_OTHER_OPPONENT_MINIONS	los otros esbirros de tu oponente	e.g. {Your other opponent's minions} took 2 damage
ACCESSIBILITY_GAMEPLAY_DIFF_GROUP_FRIENDLY_MINIONS	tus esbirros	e.g. {Your minions} took 2 damage
ACCESSIBILITY_GAMEPLAY_DIFF_GROUP_OTHER_FRIENDLY_MINIONS	tus otros esbirros	e.g. {Your other minions} took 2 damage
ACCESSIBILITY_GAMEPLAY_DIFF_GROUP_FRIENDLY_SAME_NAME_ENTITIES	tus {0} {1}	0=count 1=minion name e.g. Your {2} {Raid Leader}
ACCESSIBILITY_GAMEPLAY_DIFF_GROUP_OPPONENT_SAME_NAME_ENTITIES	los {0} de tu oponente {1}	0=count 1=minion name e.g. Your opponent's {2} {Raid Leader}

ACCESSIBILITY_GAMEPLAY_DIFF_MOVEMENT_PLAYER_EQUIPPED_WEAPON	tu héroe equipa 1 {0}	0=weapon name e.g. your Hero equipped 1 {Fiery War Axe}
ACCESSIBILITY_GAMEPLAY_DIFF_MOVEMENT_OPPONENT_EQUIPPED_WEAPON	el héroe de tu oponente equipa 1 {0}	0=weapon name e.g. your opponent's Hero equipped 1 {Fiery War Axe}
ACCESSIBILITY_GAMEPLAY_DIFF_MOVEMENT_PLAYER_HERO_POWER_CHANGED	tu poder de héroe cambia a {0}	0=hero power name e.g. your Hero Power became {Fireblast}
ACCESSIBILITY_GAMEPLAY_DIFF_MOVEMENT_OPPONENT_HERO_POWER_CHANGED	el poder de héroe de tu oponente cambia a{0}	0=hero power name e.g. your opponent's Hero Power became {Fireblast}
ACCESSIBILITY_GAMEPLAY_DIFF_MOVEMENT_ENTITY_RETURNED_TO_PLAYER_HAND	vuelve a tu mano	e.g. Your Bloodfen Raptor {returned to your hand}
ACCESSIBILITY_GAMEPLAY_DIFF_MOVEMENT_MULTIPLE_ENTITIES_RETURNED_TO_PLAYER_HAND	vuelven a tu mano	e.g. Your 2 Bloodfen Raptor {returned to your hand}
ACCESSIBILITY_GAMEPLAY_DIFF_MOVEMENT_ENTITY_RETURNED_TO_OPPONENT_HAND	vuelve a la mano de tu oponente	e.g. Your Bloodfen Raptor {returned to your opponent's hand}
ACCESSIBILITY_GAMEPLAY_DIFF_MOVEMENT_MULTIPLE_ENTITIES_RETURNED_TO_OPPONENT_HAND	vuelven a la mano de tu oponente	e.g. Your 2 Bloodfen Raptor {returned to your opponent's hand}
ACCESSIBILITY_GAMEPLAY_DIFF_MOVEMENT_ENTITY_MOVED_FROM_ZONE_TO_ZONE	ha sido movido desde {0} a {1}	0=from zone name 1=to zone name e.g. Your Bloodfen raptor moved from {your hand} to {your opponent's deck}
ACCESSIBILITY_GAMEPLAY_DIFF_MOVEMENT_MULTIPLE_ENTITIES_MOVED_FROM_ZONE_TO_ZONE	han sido movidos desde {0} a {1}	0=from zone name 1=to zone name e.g. Your 2 Bloodfen raptor moved from {your hand} to {your opponent's deck}
ACCESSIBILITY_GAMEPLAY_DIFF_MOVEMENT_ENTITY_MOVED_TO_ZONE	ha sido movido a {0}	0=zone name e.g. Your Bloodfen Raptor moved to {your opponent's deck}
ACCESSIBILITY_GAMEPLAY_DIFF_MOVEMENT_MULTIPLE_ENTITIES_MOVED_TO_ZONE	han sido movidos a {0}	0=zone name e.g. Your 2 Bloodfen Raptor moved to {your opponent's deck}
ACCESSIBILITY_GAMEPLAY_DIFF_MOVEMENT_ENTITY_MOVED_ZONES_GENERIC	moved zones	e.g. Your Bloodfen Raptor {moved zones}
ACCESSIBILITY_GAMEPLAY_DIFF_MOVEMENT_MULTIPLE_ENTITIES_MOVED_ZONES_GENERIC	moved zones	e.g. Your 2 Bloodfen Raptor {moved zones}

ACCESSIBILITY_GAMEPLAY_DIFF_MOVEMENT_CARD_ADDED_TO_PLAYER_HAND	se ha añadido 1 {0} a tu mano	0=card name e.g. 1 {Murloc Raider} was added to your hand
ACCESSIBILITY_GAMEPLAY_DIFF_MOVEMENT_CARDS_ADDED_TO_PLAYER_HAND	se añadieron {0} a tu mano	0=card names e.g. {2 Murloc Raider} were added to your hand
ACCESSIBILITY_GAMEPLAY_DIFF_MOVEMENT_CARD_ADDED_TO_OPPONENT_HAND	1 {0} se ha añadido a la mano de tu oponente	0=card name e.g. 1 {Murloc Raider} was added to your opponent's hand
ACCESSIBILITY_GAMEPLAY_DIFF_MOVEMENT_CARDS_ADDED_TO_OPPONENT_HAND	{0} han sido agregadas a la mano de tu oponente	0=card names e.g. {2 Murloc Raider} were added to your opponent's hand
ACCESSIBILITY_GAMEPLAY_DIFF_MOVEMENT_CARD_ADDED_TO_PLAYER_DECK	1 {0} se ha barajado en tu mazo	0=card name e.g. 1 {Fireball} was shuffled into your deck
ACCESSIBILITY_GAMEPLAY_DIFF_MOVEMENT_CARDS_ADDED_TO_PLAYER_DECK	{0} se han barajado en tu mazo	0=card names e.g. {2 Fireball} were shuffled into your deck
ACCESSIBILITY_GAMEPLAY_DIFF_MOVEMENT_CARD_ADDED_TO_OPPONENT_DECK	1 {0} se ha barajado en el mazo de tu oponente	0=card name e.g. 1 {Fireball} was shuffled into your opponent's deck
ACCESSIBILITY_GAMEPLAY_DIFF_MOVEMENT_CARDS_ADDED_TO_OPPONENT_DECK	{0} se han barajado en el mazo de tu oponente	0=card names e.g. {2 Fireball} were shuffled into your opponent's deck
ACCESSIBILITY_GAMEPLAY_DIFF_MOVEMENT_CARD_ADDED_TO_PLAYER_BATTLEFIELD	1 {0} ha sido invocado a tu campo de batalla	0=card name e.g. 1 {Murloc Raider} was summoned into your battlefield
ACCESSIBILITY_GAMEPLAY_DIFF_MOVEMENT_CARDS_ADDED_TO_PLAYER_BATTLEFIELD	{0}han sido invocados a tu campo de batalla	0=card names e.g. {2 Murloc Raider} were summoned into your battlefield
ACCESSIBILITY_GAMEPLAY_DIFF_MOVEMENT_CARD_ADDED_TO_OPPONENT_BATTLEFIELD	1 {0} ha sido invocado al campo de batalla de tu oponente	0=card name e.g. 1 {Murloc Raider} was summoned into your opponent's battlefield
ACCESSIBILITY_GAMEPLAY_DIFF_MOVEMENT_CARDS_ADDED_TO_OPPONENT_BATTLEFIELD	{0}han sido invocados al campo de batalla de tu oponente	0=card names e.g. {2 Murloc Raider} were summoned into your opponent's battlefield
ACCESSIBILITY_GAMEPLAY_DIFF_MOVEMENT_CARDS_TAKEN_CONTROL_BY_PLAYER	tomas el control de {0}	0=card names
ACCESSIBILITY_GAMEPLAY_DIFF_MOVEMENT_CARDS_TAKEN_CONTROL_BY_OPPONENT	tu oponente tomó el control de {0}	0=card names

ACCESSIBILITY_GAMEPLAY_DIFF_PLAYER_GAINED_SPELL_DAMAGE	ganas {0} daño con hechizo	0=spell damage
ACCESSIBILITY_GAMEPLAY_DIFF_PLAYER_LOST_SPELL_DAMAGE	pierdes {0} daño con hechizo	0=spell damage
ACCESSIBILITY_GAMEPLAY_DIFF_OPPONENT_GAINED_SPELL_DAMAGE	tu oponente gana {0} daño con hechizo	0=spell damage
ACCESSIBILITY_GAMEPLAY_DIFF_OPPONENT_LOST_SPELL_DAMAGE	tu oponente pierde {0} Sdaño con hechizo	0=spell damage

ACCESSIBILITY_GAMEPLAY_DIFF_PLAYER_GAINED_MANA	ganas {0} maná	0=amount
ACCESSIBILITY_GAMEPLAY_DIFF_OPPONENT_GAINED_MANA	tu oponente gana {0} maná	0=amount
ACCESSIBILITY_GAMEPLAY_DIFF_PLAYER_GAINED_MANA_AND_EMPTY_MANA_CRYSTALS	ganas {0} maná y {1} |4(empty mana crystal,empty mana crystals)	0=mana gained 1=empty mana crystals gained
ACCESSIBILITY_GAMEPLAY_DIFF_OPPONENT_GAINED_MANA_AND_EMPTY_MANA_CRYSTALS	Your opponent gained {0} mana and {1} |4(empty mana crystal,empty mana crystals)	0=mana gained 1=empty mana crystals gained
ACCESSIBILITY_GAMEPLAY_DIFF_PLAYER_GAINED_EMPTY_MANA_CRYSTALS	You gained {0} |4(empty mana crystal,empty mana crystals)	0=amount
ACCESSIBILITY_GAMEPLAY_DIFF_OPPONENT_GAINED_EMPTY_MANA_CRYSTALS	Your opponent gained {0} |4(empty mana crystal,empty mana crystals)	0=amount

ACCESSIBILITY_GAMEPLAY_SEE_PLAYER_HERO_HELP	pulsa {0} para examinar a tu héroe	0=v key
ACCESSIBILITY_GAMEPLAY_SEE_OPPONENT_HERO_HELP	pulsa {0} para examinar al héroe de tu oponente	0=f key
ACCESSIBILITY_GAMEPLAY_READ_CARDS_HELP	usa las flechas arriba y abajo para leer las cartas	
ACCESSIBILITY_GAMEPLAY_CONFIRM_TO_ATTACK_TARGET	pulsa {0} para atacar a este objetivo	0=Enter key
ACCESSIBILITY_GAMEPLAY_PRESS_ENTER_TO_SUMMON_THIS_MINION	pulsa {0} para invocar a este esbirro	0=Enter key
ACCESSIBILITY_GAMEPLAY_OPPONENT_TURN_VOICE	tu oponente está jugando	
ACCESSIBILITY_GAMEPLAY_CONFIRM_END_TURN_HELP	Pulsa {0} o {1} para terminar tu turno. Pulsa cualquier otra tecla para cancelar	0=enter key 1=e key
ACCESSIBILITY_GAMEPLAY_SEE_VALID_OPTIONS	Usa {0} para revisar tus jugadas válidas	0=tab key
ACCESSIBILITY_GAMEPLAY_SEE_PLAYER_HAND_HELP	Pulsa {0} para mirar tu mano	0=c key
ACCESSIBILITY_GAMEPLAY_COUNT_OPPONENT_HAND_HELP	Pulsa {0} para conocer el número de cartas en la mano de tu oponente	0=Shift+c keys
ACCESSIBILITY_GAMEPLAY_SEE_PLAYER_MINIONS_HELP	Pulsa {0} para ver los esbirros que has invocado	0=b key
ACCESSIBILITY_GAMEPLAY_SEE_OPPONENT_MINIONS_HELP	pulsa {0} para ver los esbirros de tu oponente	0=g key
ACCESSIBILITY_GAMEPLAY_SEE_PLAYER_SECRETS_HELP	pulsa {0} para ver tus secretos	0=s key
ACCESSIBILITY_GAMEPLAY_COUNT_OPPONENT_SECRETS_HELP	pulsa {0} para ver los secretos de tu oponente	0=Shift+s keys
ACCESSIBILITY_GAMEPLAY_READ_PLAYER_WEAPON_HELP	pulsa{0} para ver tu arma	0=w key
ACCESSIBILITY_GAMEPLAY_READ_OPPONENT_WEAPON_HELP	pulsa {0} para ver el arma de tu oponente	0=Shift+w keys
ACCESSIBILITY_GAMEPLAY_READ_PLAYER_HERO_POWER_HELP	pulsa {0} para ver tu poder de héroe	0=r key
ACCESSIBILITY_GAMEPLAY_READ_OPPONENT_HERO_POWER_HELP	pulsa {0} para ver el poder de héroe de tu oponente	0=Shift+r keys
ACCESSIBILITY_GAMEPLAY_COUNT_PLAYER_DECK_HELP	pulsa {0} para conocer las cartas restantes de tu mazo	0=d key
ACCESSIBILITY_GAMEPLAY_COUNT_OPPONENT_DECK_HELP	pulsa {0} para conocer el número de cartas en el mazo de tu oponente	0=Shift+d keys
ACCESSIBILITY_GAMEPLAY_READ_PLAYER_MANA_HELP	pulsa {0} para ver tu cantidad de maná	0=a key
ACCESSIBILITY_GAMEPLAY_READ_OPPONENT_MANA_HELP	pulsa {0} para ver la cantidad de maná de tu oponente	0=Shift+a key
ACCESSIBILITY_GAMEPLAY_READ_CARD_HELP	utiliza las flechas arriba y abajo para leer esta carta	
ACCESSIBILITY_GAMEPLAY_READ_CARD_TOOLTIP_HELP	pulsa {0} para obtener una descripción de las habilidades de esta carta	0=i key
ACCESSIBILITY_GAMEPLAY_PLAY_CARD_HELP	pulsa {0} para jugar esta carta	0=Enter key
ACCESSIBILITY_GAMEPLAY_SUMMON_MINION_HELP	pulsa {0} para invocar este esbirro	0=Enter key
ACCESSIBILITY_GAMEPLAY_CHOICE_MODE_HELP	usa las flechas para revisar tus opciones. pulsa {0} para escoger una	0=Enter key
ACCESSIBILITY_GAMEPLAY_CHOOSE_TARGET_HELP	Usa {0} o las teclas de zona para pasar por tus objetivos. Pulsa {1} para elegir un objetivo o {2} para cancelar	0=Tab key 1=Enter key 2=Backspace key
ACCESSIBILITY_GAMEPLAY_ATTACK_WITH_MINION_HELP	Pulsa {0} para atacar con este esbirro	0=Enter key
ACCESSIBILITY_GAMEPLAY_ATTACK_WITH_HERO_HELP	Pulsa {0} para atacar con tu héroe	0=Enter key
ACCESSIBILITY_GAMEPLAY_USE_HERO_POWER_HELP	Pulsa {0} para usar tu poder de héroe	0=Enter key
ACCESSIBILITY_GAMEPLAY_READ_THROUGH_VALID_TARGETS	Usa {0} para leer tus objetivos válidos	0=Tab key
ACCESSIBILITY_GAMEPLAY_ATTACK_THIS_MINION_HELP	Pulsa {0} para atacar a este esbirro	0=Enter key
ACCESSIBILITY_GAMEPLAY_CANCEL_ATTACK_HELP	Pulsa {0} para cancelar el ataque	0=Backspace key
ACCESSIBILITY_GAMEPLAY_CANCEL_HELP	Pulsa {0} para cancelar	0=Backspace key
ACCESSIBILITY_GAMEPLAY_SUMMONING_CHOOSE_POSITION_HELP	Usa las flechas izquierda y derecha para elegir la posición de este esbirro	
ACCESSIBILITY_GAMEPLAY_OPEN_HISTORY_LOG_HELP	Pulsa {0} para abrir el historial	0=y key
ACCESSIBILITY_GAMEPLAY_READ_HISTORY_HELP	Pulsa las flechas arriba y abajo para leer el historial y pulsa {0} para cerrarlo	0=Backspace key
ACCESSIBILITY_GAMEPLAY_END_TURN_HELP	pulsa {0} para terminar tu turno	0=e key

ACCESSIBILITY_GAMEPLAY_HISTORY_LOG_EMPTY	aún nos e ha jugado nada	
ACCESSIBILITY_GAMEPLAY_HISTORY_LOG_ENTRY_FORMAT	{0} de {1} {2}	0=current entry 1=number of entries 2=entry e.g. {5} of {7} {your Hero took 5 damage}
ACCESSIBILITY_GAMEPLAY_HISTORY_LOG_CLOSE	Se detuvo la lectura del historial	

ACCESSIBILITY_GAMEPLAY_SPECIAL_STARTING_PLAYER_BATTLEFIELD	Tu campo de batalla comienza con {0}	0=starting cards e.g. Your battlefield starts with {4 Gates of Theramore}
ACCESSIBILITY_GAMEPLAY_SPECIAL_STARTING_OPPONENT_BATTLEFIELD	El campo de batalla de tu oponente comienza con {0}	0=starting cards e.g. Your opponent's battlefield starts with {1 Vicious Bear Trap}

ACCESSIBILITY_UI_POPUP	Ventana emergente	
ACCESSIBILITY_UI_REWARDS_TITLE	Recompensas	
ACCESSIBILITY_UI_UNKNOWN_POPUP	Esta ventana emergente aún no es accesible. Obtén ayuda de alguien que vea.	
ACCESSIBILITY_UI_UNKNOWN_DIALOG	Este cuadro de diálogo aún no es accesible. Obtén ayuda de alguien que vea	

ACCESSIBILITY_UI_ALERT_POPUP_TITLE	Ventana de alerta	

ACCESSIBILITY_UI_REWARD_SCROLL_TITLE	Has completado una misión	
ACCESSIBILITY_UI_REWARD_SCROLL_HELP	Utiliza las flechas para revisar tus recompensas	

ACCESSIBILITY_UI_QUEST_NOTIFICATION_POPUP_TITLE	Tienes {0} |4(misión,misiones)	0=number of quests
ACCESSIBILITY_UI_QUEST_NOTIFICATION_POPUP_HELP	Usa las flechas para leer tus misiones.	

ACCESSIBILITY_UI_WELCOME_QUESTS_HELP	Utiliza las flechas direccionales para leer tus |4(misión,misiones)	

ACCESSIBILITY_UI_REWARD_TITLE	¡Tienes una recompensa!	
ACCESSIBILITY_UI_REWARD_HELP	Usa las flechas para leer la recompensa	

ACCESSIBILITY_UI_RANKED_INTRO_POPUP	¡El nuevo sistema de ranking ya está aquí! Puedes encontrar más información sobre esto en línea.	

ACCESSIBILITY_UI_RANKED_BONUS_STARS_POPUP	¡Tu actuación en las partidas de Ranking de la temporada pasada te otorgó una bonificación de {0} estrellas!	0=star bonus amount

ACCESSIBILITY_UI_RECONNECT_HELPER_DIALOG_TITLE	Diálogo de reconexión	

ACCESSIBILITY_UI_SEASON_END_DIALOG_RANK_EARNED	{0} ha finalizado. Alcanzaste el rango de {1}	0=season name 1=rank name e.g. {July 2021 season} has ended. You achieved the rank of {Diamond 1}
ACCESSIBILITY_UI_SEASON_END_DIALOG_CHEST_EARNED	Has ganado un cofre de recompensas	
ACCESSIBILITY_UI_SEASON_END_DIALOG_CHEST_EARNED_HELP	Pulsa {0} para abrir	0=Enter key
ACCESSIBILITY_UI_SEASON_END_DIALOG_SEASON_WELCOME	La {0} ha comenzado!	0=season name e.g. The {August 2021 season} has begun!
ACCESSIBILITY_UI_SEASON_END_DIALOG_REDUCED_WELCOME	¡una nueva temporada ha comenzado!	
ACCESSIBILITY_UI_SEASON_END_DIALOG_REMINDER_CHEST	Gana {0} juegos esta temporada para recibir un cofre	0=number of games
ACCESSIBILITY_UI_SEASON_END_DIALOG_REMINDER_CARDBACK	Gana {0} juegos esta temporada para ganar tu dorso de carta de temporada	0=number of games

ACCESSIBILITY_UI_CARD_LIST_POPUP_HELP	Usa las flechas para leer las cartas.	

ACCESSIBILITY_UI_CHEST_REWARD_DISPLAY_TITLE	Ventana emergente de cofre de recompensas	
ACCESSIBILITY_UI_CHEST_REWARD_DISPLAY_HELP	Pulsa {0} para abrir tu cofre de recompensas	0=Enter key

ACCESSIBILITY_UI_RANKED_REWARD_DISPLAY	Obtuviste una recompensa de ranking, pero el modo de ranking no es accesible aún	

ACCESSIBILITY_UI_REWARD_BOXES_DISPLAY_TITLE	Obtuviste {0} |4(Paquete de recompensa,Paquete de recompensas!	
ACCESSIBILITY_UI_REWARD_BOXES_DISPLAY_HELP	Use las  flechas direccionales y {0} para abrir tus recompensas	0=Enter key

ACCESSIBILITY_UI_QUEST_NO_NAME_XP_ONLY	{0} XP quest	0=xp rewarded by quest. Note: these quests don't have a name
ACCESSIBILITY_UI_QUEST_REWARD_DESCRIPTION	Rewards {0}	0=rewards e.g. Rewards {2 cards and 1 card pack from recent expansions}
ACCESSIBILITY_UI_QUEST_REWARD_CHOOSE_ONE_DESCRIPTION	Rewards 1 of {0}	0=possible rewards e.g. Rewards 1 of {2 card packs from recent expansions, 2 cards and 2 hero skins}

ACCESSIBILITY_UI_REWARD_TYPE_REWARD_PACKAGE	Reward package	
ACCESSIBILITY_UI_REWARD_TYPE_ONE_CARD_PACK	1 card pack	
ACCESSIBILITY_UI_REWARD_TYPE_ONE_CARD	1 card	
ACCESSIBILITY_UI_REWARD_TYPE_ONE_CARD_BACK	1 card back	
ACCESSIBILITY_UI_REWARD_TYPE_ONE_MOUNT	1 mount	
ACCESSIBILITY_UI_REWARD_TYPE_ONE_MINI_SET	1 mini set	
ACCESSIBILITY_UI_REWARD_TYPE_UNKNOWN	1 unknown reward	
ACCESSIBILITY_UI_REWARD_N_TICKETS	{0} |4(ticket,tickets)	0=number of tickets
ACCESSIBILITY_UI_REWARD_MINI_SET_WITH_N_CARDS	Mini set with {0} cards	0=number of cards
ACCESSIBILITY_UI_REWARD_N_ARCANE_ORBS	{0} arcane orbs	0=amount
ACCESSIBILITY_UI_REWARD_N_ARCANE_DUST	{0} arcane dust	0=amount
ACCESSIBILITY_UI_REWARD_N_CARD_PACKS	{0} |4(card pack,card packs)	0=amount
ACCESSIBILITY_UI_REWARD_N_GOLD	{0} gold	0=amount
ACCESSIBILITY_UI_REWARD_CARD_FROM_CLASS	{0} |4(copy,copies) of 1 {1} card	0=number of copies 1=class e.g. {2} copies of 1 {mage} card
ACCESSIBILITY_UI_REWARD_CORE_CARD_FROM_CLASS	{0} |4(copy,copies) of 1 core {1} card	0=number of copies 1=class e.g. {2} copies of 1 core {mage} card
ACCESSIBILITY_UI_REWARD_GOLDEN_HERO	Golden {0}	0=Hero name e.g. Golden Jaina Proudmoore
ACCESSIBILITY_UI_REWARD_CLASS_HERO	{0} Hero	0=class e.g. Mage Hero
ACCESSIBILITY_UI_REWARD_CLASS_UNLOCK_PROGRESS	{0} out of {1} Heroes unlocked	0=number of unlocked Heroes 1=total number of Heroes
ACCESSIBILITY_UI_REWARD_CARD	{0} |4(,copies of 1) card	0=number of copies
ACCESSIBILITY_UI_REWARD_N_HERO_SKINS	{0} |4(Hero skin,Hero skins)	0=amount
ACCESSIBILITY_UI_REWARD_N_CARD_BACKS	{0} |4(Card back,Card backs)	0=amount
ACCESSIBILITY_UI_REWARD_N_ARENA_TICKETS	{0} |4(Arena ticket,Arena tickets)	0=amount
ACCESSIBILITY_UI_REWARD_N_RUNESTONES	{0} |4(Runestone,Runestones)	0=amount
ACCESSIBILITY_UI_REWARD_N_ADVENTURES	{0} |4(Adventure,Adventures)	0=amount
ACCESSIBILITY_UI_REWARD_N_TAVERN_BRAWL_TICKETS	{0} |4(Tavern Brawl ticket,Tavern Brawl tickets)	0=amount
ACCESSIBILITY_UI_REWARD_N_CUSTOM_COINS	{0} |4(custom coin,custom coins)	0=amount
ACCESSIBILITY_UI_REWARD_XP_BOOST	{0}% XP boost	0=amount
ACCESSIBILITY_UI_REWARD_N_MINI_SETS	{0} |4(Mini set,Mini sets)	0=amount
ACCESSIBILITY_UI_REWARD_N_BATTLEGROUNDS_HERO_SKINS	{0} |4(Battlegrounds Hero skin,Battlegrounds Hero skins)	0=amount
ACCESSIBILITY_UI_REWARD_N_BATTLEGROUNDS_GUIDE_SKINS	{0} |4(Battlegrounds guide skin,Battlegrounds guide skins)	0=amount

ACCESSIBILITY_SCREEN_GO_BACK	Go back	

ACCESSIBILITY_SCREEN_FATAL_ERROR_SCREEN_TITLE	Fatal error screen	

ACCESSIBILITY_SCREEN_END_GAME_SCREEN_HERO_LEVEL_UP	Your Hero reached level {0}	0=level

ACCESSIBILITY_SCREEN_CHOOSE_ADVENTURER_SCREEN_TITLE	Choose adventurer screen	
ACCESSIBILITY_SCREEN_CHOOSE_ADVENTURER_SCREEN_HERO_CHOSEN_HELP	Press {0} to start or {1} to go back to the main menu	0=Enter key 1=Backspace key

ACCESSIBILITY_SCREEN_ADVENTURE_SCREEN_TITLE	Adventure screen	
ACCESSIBILITY_SCREEN_ADVENTURE_SCREEN_CHOOSE_ADVENTURER_TITLE	Choose an adventurer	
ACCESSIBILITY_SCREEN_ADVENTURE_SCREEN_ADVENTURE_MENU_TITLE	Adventure menu	
ACCESSIBILITY_SCREEN_ADVENTURE_SCREEN_ADVENTURE_MENU_PLAY_OPTION	Play	
ACCESSIBILITY_SCREEN_ADVENTURE_SCREEN_ADVENTURE_MENU_READ_DECK_OPTION	Read Deck	
ACCESSIBILITY_SCREEN_ADVENTURE_SCREEN_ADVENTURE_MENU_RETIRE_OPTION	Retire	
ACCESSIBILITY_SCREEN_ADVENTURE_SCREEN_WAITING_FOR_VO_HELP	Waiting for voice-over to end	
ACCESSIBILITY_SCREEN_ADVENTURE_SCREEN_READING_DECK_HELP	Use the arrow keys to read your cards	
ACCESSIBILITY_SCREEN_ADVENTURE_SCREEN_CANT_READ_DECK	You can't read your deck in this adventure	
ACCESSIBILITY_SCREEN_ADVENTURE_SCREEN_ADVENTURE_COMPLETE	Adventure complete	
ACCESSIBILITY_SCREEN_ADVENTURE_SCREEN_PROGRESS_MESSAGE	You're on opponent number {0} out of {1}	0=current opponent number 1=number of opponents

ACCESSIBILITY_SCREEN_CHOOSE_ADVENTURE_SCREEN_MENU_TITLE	Choose an adventure	
ACCESSIBILITY_SCREEN_CHOOSE_ADVENTURE_SCREEN_MENU_BOOK_OF_HEROES_OPTION	Book of Heroes	
ACCESSIBILITY_SCREEN_CHOOSE_ADVENTURE_SCREEN_PRACTICE_CHOOSE_DIFFICULTY_MENU_TITLE	Choose your opponent's difficulty	
ACCESSIBILITY_SCREEN_CHOOSE_ADVENTURE_SCREEN_PRACTICE_CHOOSE_DIFFICULTY_MENU_NORMAL_OPTION	Normal	
ACCESSIBILITY_SCREEN_CHOOSE_ADVENTURE_SCREEN_PRACTICE_CHOOSE_DIFFICULTY_MENU_EXPERT_OPTION	Expert	
ACCESSIBILITY_SCREEN_CHOOSE_ADVENTURE_SCREEN_PRACTICE_CHOOSE_EXPERT_LOCKED	You must beat all normal opponents to unlock expert	

ACCESSIBILITY_SCREEN_CHOOSE_OPPONENT_MENU_TITLE	Choose your opponent	
ACCESSIBILITY_SCREEN_CHOOSE_OPPONENT_MENU_UNDEFEATED_OPPONENT_LABEL	Undefeated {0}	0=class name e.g. Undefeated {Demon Hunter}

ACCESSIBILITY_SCREEN_CHOOSE_DECK_TITLE	Choose your deck	

ACCESSIBILITY_TOAST_QUEST_PROGRESS_TOAST_TITLE	Quest progress toast	
ACCESSIBILITY_TOAST_QUEST_PROGRESS_TOAST_PROGRESS	Current progress is {0} out of {1}	0=current progress 1=total

ACCESSIBILITY_TOAST_QUEST_TOAST_TITLE	You finished a quest	

ACCESSIBILITY_TUTORIAL_LOADING_TUTORIAL	Loading tutorial	
ACCESSIBILITY_TUTORIAL_WELCOME_BACK	Welcome back to the tutorial	
ACCESSIBILITY_TUTORIAL_DEFEATED_HOGGER	You've defeated Hogger	
ACCESSIBILITY_TUTORIAL_DEFEATED_MILLHOUSE	You've defeated Millhouse Manastorm	
ACCESSIBILITY_TUTORIAL_DEFEATED_CHO	You've defeated Lorewalker Cho	
ACCESSIBILITY_TUTORIAL_DEFEATED_MUKLA	You've defeated King Mukla	
ACCESSIBILITY_TUTORIAL_DEFEATED_NESINGWARY	You've defeated Hemet Nesingwary	
ACCESSIBILITY_TUTORIAL_DEFEATED_ILLIDAN	You've defeated Illidan Stormrage	
ACCESSIBILITY_TUTORIAL_NEXT_HOGGER	Your next opponent is Hogger	
ACCESSIBILITY_TUTORIAL_NEXT_MILLHOUSE	Your next opponent is Millhouse Manastorm	
ACCESSIBILITY_TUTORIAL_NEXT_CHO	Your next opponent is Lorewalker Cho	
ACCESSIBILITY_TUTORIAL_NEXT_MUKLA	Your next opponent is King Mukla	
ACCESSIBILITY_TUTORIAL_NEXT_NESINGWARY	Your next opponent is Hemet Nesingwary	
ACCESSIBILITY_TUTORIAL_NEXT_ILLIDAN	Your next and final opponent is Illidan Stormrage	

ACCESSIBILITY_TUTORIAL_NARRATOR_INTRO	I'll be teaching you how to play through a set of six tutorial games	
ACCESSIBILITY_TUTORIAL_NARRATOR_HELP_KEYS	If you ever feel lost, press {0}. Even after the tutorial or when navigating menus, you can always use {0} whenever you need help	0=F1 key
ACCESSIBILITY_TUTORIAL_NARRATOR_INTRO_END	Alright, let's get on with it	
ACCESSIBILITY_TUTORIAL_FREE_STARTING_PACK	Here's a basic Mage pack of cards to get you started. Press {0} to open it	0=Enter key
ACCESSIBILITY_TUTORIAL_NICE_WORK	Nice work	
ACCESSIBILITY_TUTORIAL_NICE_JOB	Nice job	
ACCESSIBILITY_TUTORIAL_NICE_ONE	Nice one	
ACCESSIBILITY_TUTORIAL_GOOD_JOB	Good job	
ACCESSIBILITY_TUTORIAL_YOU_GOT_IT	You got it!	
ACCESSIBILITY_TUTORIAL_REMEMBER_HOW_TO_DO_IT	Remember how to do it?	
ACCESSIBILITY_TUTORIAL_REMEMBER_HOW_TO_DO_THAT	Remember how to do that?	
ACCESSIBILITY_TUTORIAL_TRY_IT_OUT	Try it out!	
ACCESSIBILITY_TUTORIAL_ALL_RIGHT	All right!	
ACCESSIBILITY_TUTORIAL_LETS_LEARN_HOW	Let's learn how	
ACCESSIBILITY_TUTORIAL_CAN_YOU_DO_IT	Can you do it?	
ACCESSIBILITY_TUTORIAL_THINK_YOU_CAN_DO_IT	Think you can do it?	
ACCESSIBILITY_TUTORIAL_GOT_IT	Got it	
ACCESSIBILITY_TUTORIAL_NO_ENDTURN_HP	Not yet! Use your Hero Power. Press {0} to select it	0=r key

ACCESSIBILITY_TUTORIAL_HOGGER_START	Your first opponent is a gnoll named Hogger. You will be playing as the powerful mage Jaina Proudmoore	
ACCESSIBILITY_TUTORIAL_HOGGER_FORCE_CARD_READ	Use the up and down arrow keys to read this card first	
ACCESSIBILITY_TUTORIAL_HOGGER_SUMMON_MINION_FIRST	Summon the minion you just got first	
ACCESSIBILITY_TUTORIAL_HOGGER_FORCE_LOOK_AT_OPPONENT_MINIONS_FIRST	Use {0} and the arrow keys to read your opponent's minions first	0=g key
ACCESSIBILITY_TUTORIAL_HOGGER_2_0	When a turn starts, you always begin by drawing a card from your deck. Let's see the one we just drew	
ACCESSIBILITY_TUTORIAL_HOGGER_2_1	Press {0} to look at the cards in your hand	0=c key
ACCESSIBILITY_TUTORIAL_HOGGER_2_2	Ok, so... This card is a minion named Murloc Raider	
ACCESSIBILITY_TUTORIAL_HOGGER_2_2B	Minions are creatures that you can summon onto the battlefield to fight for your Hero	
ACCESSIBILITY_TUTORIAL_HOGGER_2_2D	This one costs 1 mana to summon and has 2 attack and 1 health	
ACCESSIBILITY_TUTORIAL_HOGGER_2_3	Let's start by summoning this minion	
ACCESSIBILITY_TUTORIAL_HOGGER_2_4	Press {0} to do so	0=Enter key
ACCESSIBILITY_TUTORIAL_HOGGER_2_5	Press {0} to confirm or {1} to cancel	0=Enter key 1=Backspace key
ACCESSIBILITY_TUTORIAL_HOGGER_2_6	Minions must wait a turn to attack once they're summoned, so we have nothing left to do	
ACCESSIBILITY_TUTORIAL_HOGGER_3_0	Your opponent's minion attacked your Hero so you took some damage	
ACCESSIBILITY_TUTORIAL_HOGGER_3_1	Let's see how much health we have left	
ACCESSIBILITY_TUTORIAL_HOGGER_3_2	Use the up and down arrow keys to read your hero card	
ACCESSIBILITY_TUTORIAL_HOGGER_3_2_HELP	Use {0} and the arrow keys to find out how much health your Hero has	0=v key
ACCESSIBILITY_TUTORIAL_HOGGER_3_3	If your Hero runs out of health, you lose. 28 health is still plenty though	
ACCESSIBILITY_TUTORIAL_HOGGER_3_4	Let's look at your opponent's hero now. Press {0}	0=f key
ACCESSIBILITY_TUTORIAL_HOGGER_3_5	Can you find how much health he has?	
ACCESSIBILITY_TUTORIAL_HOGGER_3_5_HELP	Use the up and down arrow keys to read your opponent's hero card	
ACCESSIBILITY_TUTORIAL_HOGGER_3_6	Once your opponent's Hero runs out of health, you win	
ACCESSIBILITY_TUTORIAL_HOGGER_3_7	Let's carry on	
ACCESSIBILITY_TUTORIAL_HOGGER_4_1	Looks like you got another minion. Can you summon this one yourself?	
ACCESSIBILITY_TUTORIAL_HOGGER_4_1_HELP	Use {0} and {1} to summon your minion	0=c key 1=Enter key
ACCESSIBILITY_TUTORIAL_HOGGER_4_2	When you already have minions on the battlefield, you can use the left and right arrow keys to select where the new minion will be placed	
ACCESSIBILITY_TUTORIAL_HOGGER_4_4	You now have two minions on the battlefield. This one was just summoned so it must wait a turn to attack	
ACCESSIBILITY_TUTORIAL_HOGGER_4_5	Let's learn how to navigate the battlefield	
ACCESSIBILITY_TUTORIAL_HOGGER_4_6	Use the left and right arrow keys to navigate your minions	
ACCESSIBILITY_TUTORIAL_HOGGER_4_6_HELP	Use {0} and the arrow keys to navigate your summoned minions	0=b key
ACCESSIBILITY_TUTORIAL_HOGGER_4_8	Let's look at your opponent's minions now. Press {0} to do so	0=g key
ACCESSIBILITY_TUTORIAL_HOGGER_4_9	Can you read this minion by yourself?	
ACCESSIBILITY_TUTORIAL_HOGGER_4_9_HELP	Use the up and down arrow keys to read your opponent's minions	
ACCESSIBILITY_TUTORIAL_HOGGER_4_10	Let's try to attack this minion now	
ACCESSIBILITY_TUTORIAL_HOGGER_4_11	Select the Murloc Raider you summoned last turn	
ACCESSIBILITY_TUTORIAL_HOGGER_4_11_HELP	Use {0} to get to your minion and {1} to launch an attack	0=b key 1=Enter key
ACCESSIBILITY_TUTORIAL_HOGGER_4_12	Press {0} to attack with this minion	0=Enter key
ACCESSIBILITY_TUTORIAL_HOGGER_4_13	Can you attack your opponent's minion?	
ACCESSIBILITY_TUTORIAL_HOGGER_4_13_HELP	Use {0} and {1} to attack your opponent's minion	0=g key 1=Enter key
ACCESSIBILITY_TUTORIAL_HOGGER_4_16	Both minions had 2 attack and 1 health so they killed each other	
ACCESSIBILITY_TUTORIAL_HOGGER_4_17	Your other minion is still exhausted so there's nothing left to do. Remember how to end your turn?	
ACCESSIBILITY_TUTORIAL_HOGGER_6_1	Looks like you got another minion	
ACCESSIBILITY_TUTORIAL_HOGGER_6_2	This means you have two possible options right now	
ACCESSIBILITY_TUTORIAL_HOGGER_6_3	You can either summon the minion you just got, or use the one you summoned last turn to launch an attack	
ACCESSIBILITY_TUTORIAL_HOGGER_6_4	One way to do this would be using keys such as {0} to look at your hand or {1} to look at your summoned minions	0=c key 1=b key
ACCESSIBILITY_TUTORIAL_HOGGER_6_5	However, there's an easier way to do it	
ACCESSIBILITY_TUTORIAL_HOGGER_6_6	Press {0}	0=Tab key
ACCESSIBILITY_TUTORIAL_HOGGER_6_7	You're now looking at your first option, which would be to summon the minion you just got	
ACCESSIBILITY_TUTORIAL_HOGGER_6_8	Try pressing {0} again	0=Tab key
ACCESSIBILITY_TUTORIAL_HOGGER_6_9	You're now looking at your second option, which would be to attack with the minion you summoned last turn	
ACCESSIBILITY_TUTORIAL_HOGGER_6_10	You can always use {0} to go through your valid options, so make sure to remember this key!	0=key
ACCESSIBILITY_TUTORIAL_HOGGER_6_12	Alright. Let's begin by summoning the minion we just got	
ACCESSIBILITY_TUTORIAL_HOGGER_6_12_HELP	Use {0} or {1} and {2} to summon your minion	0=Tab key 1=c key 2=Enter key
ACCESSIBILITY_TUTORIAL_HOGGER_6_13	Let's try to attack with our other minion now	
ACCESSIBILITY_TUTORIAL_HOGGER_6_13_HELP	Use {0} or {1} to find your minion and {2} to launch an attack	0=Tab key 1=b key 2=Enter key
ACCESSIBILITY_TUTORIAL_HOGGER_6_14	You now have another choice to make. You can either attack one of your opponent's minions, or your opponent's hero himself	
ACCESSIBILITY_TUTORIAL_HOGGER_6_15	You can either use {0} to go through your valid targets or select your target directly using {1} or {2}	0=Tab key 1=g key 2=f key
ACCESSIBILITY_TUTORIAL_HOGGER_6_16	Go ahead and choose a target to attack	
ACCESSIBILITY_TUTORIAL_HOGGER_6_16_HELP	Use {0} and {1} to launch an attack	0=Tab key 1=Enter key
ACCESSIBILITY_TUTORIAL_HOGGER_6_21	We're ready to end our turn!	
ACCESSIBILITY_TUTORIAL_HOGGER_8_1	I'll let you continue playing by yourself. Just let me know if you need anything	

ACCESSIBILITY_TUTORIAL_MILLHOUSE_SEE_MANA_HELP	Press {0} at any time to see how much mana you have	0=a key

ACCESSIBILITY_TUTORIAL_CHO_1	This Voodoo Doctor healed your opponent's Hero	
ACCESSIBILITY_TUTORIAL06_HELP_02	When minions fight each other, they both take damage	

ACCESSIBILITY_TUTORIAL_MUKLA_START	In this game, you'll see some cards with abilities you haven't seen before	
ACCESSIBILITY_TUTORIAL_MUKLA_START_B	If you run into something you don't understand when reading a card such as Charge or Taunt, press {0} to get more information	0=i key
ACCESSIBILITY_TUTORIAL_MUKLA_START_C	Press {0} whenever you're ready to start	0=Enter key
ACCESSIBILITY_TUTORIAL_MUKLA_TAUNT_HELP	This gorilla your opponent just summoned has an ability named Taunt	
ACCESSIBILITY_TUTORIAL_MUKLA_TAUNT_HELP_B	Minions with Taunt must always be killed before you can attack anyone else	
ACCESSIBILITY_TUTORIAL_MUKLA_TAUNT_HELP_C	Taunt is an important ability as it can be used to protect your Hero	

ACCESSIBILITY_TUTORIAL_HEMET_HERO_POWER_HELP	A partir de este momento, tu héroe y el héroe de tu oponente normalmente tendrán un poder de héroe.	
ACCESSIBILITY_TUTORIAL_HEMET_HERO_POWER_HELP_B	Cada héroe tiene su propio poder de héroe, que puede ser  usado una vez por turno.	
ACCESSIBILITY_TUTORIAL_HEMET_HERO_POWER_HELP_C	Siempre puedes pulsar {0} para ver tu poder de héroe y {1} para ver el poder de héroe del rival	0=hero power key 1=opponent hero power key

ACCESSIBILITY_TUTORIAL05_HELP_03	Esta pelea es totalmente injusta. Culpa a los terribles diseñadores del juego	
ACCESSIBILITY_TUTORIAL05_HELP_04	¡Tus esbirros con el estado provocar pueden protegerte de los ataques!	
ACCESSIBILITY_TUTORIAL_ILLIDAN_WEAPON_EQUIPPED_HELP	Parece que tu oponente estaba equipado con un arma.	
ACCESSIBILITY_TUTORIAL_ILLIDAN_WEAPON_EQUIPPED_HELP_B	Las armas son cartas especiales que pueden ser equipadas por los héroes.	
ACCESSIBILITY_TUTORIAL_ILLIDAN_WEAPON_EQUIPPED_HELP_C	Cada arma tiene un valor de ataque y otro de durabilidad.	
ACCESSIBILITY_TUTORIAL_ILLIDAN_WEAPON_EQUIPPED_HELP_D	Una vez equipados, los héroes pueden atacar a otros personajes durante su turno.	
ACCESSIBILITY_TUTORIAL_ILLIDAN_WEAPON_EQUIPPED_HELP_E	Tu oponente equipó Warglaive of Azzinoth: un arma con 2 de ataque y 2 de durabilidad	
ACCESSIBILITY_TUTORIAL_ILLIDAN_WEAPON_EQUIPPED_HELP_F	Esto significa que el héroe de tu oponente tendrá 2 ataques durante su turno y podrá atacar a cualquiera de tus personajes.	
ACCESSIBILITY_TUTORIAL_ILLIDAN_WEAPON_EQUIPPED_HELP_G	Los magos no suelen utilizar armas, pero podrás usar algunas más adelante una vez que hayas desbloqueado otras clases	
ACCESSIBILITY_TUTORIAL_ILLIDAN_WEAPON_EQUIPPED_HELP_H	Puedes pulsar {0} en cualquier momento para ver tu arma o {1} para ver la de tu oponente	0=weapon key 1=opponent weapon key
ACCESSIBILITY_TUTORIAL_ILLIDAN_WEAPON_DURABILITY_HELP	¿Escuchas ese sonido? Las armas pierden durabilidad cada vez que son utilizadas	
ACCESSIBILITY_TUTORIAL_ILLIDAN_WEAPON_DURABILITY_HELP_B	Una vez que alcanzan 0 de durabilidad, se rompen y el héroe ya no puede atacar con ellas	

ACCESSIBILITY_IN_GAME_TUTORIAL_MULLIGAN_FIRST_TIME	Todo juego normal comienza con la fase de mulligan	
ACCESSIBILITY_IN_GAME_TUTORIAL_MULLIGAN_FIRST_TIME_B	En esta fase, ambos jugadores pueden reemplazar cartas de su mano inicial con otras cartas aleatorias de su mazo	
ACCESSIBILITY_IN_GAME_TUTORIAL_MULLIGAN_FIRST_TIME_C	Utilice las teclas de flecha o {0} para explorar tu mano inicial	0=Tab key
ACCESSIBILITY_IN_GAME_TUTORIAL_MULLIGAN_FIRST_TIME_D	Si ves una tarjeta que no te gusta o interesa, pulsa {0} para marcarla y que sea  reemplazada	0=Spacebar key
ACCESSIBILITY_IN_GAME_TUTORIAL_MULLIGAN_FIRST_TIME_E	Una vez que hayas marcado todas las cartas que deseas reemplazar, pulsa {0} para robar nuevas cartas e iniciar el juego	0=Enter key

